var maze = [［'#','#','#','#','#','#','#','#','#','#'］,
［'#',' ',' ',' ',' ',' ',' ','#',' ','#'］,
［'#',' ','#',' ','#','#',' ','#',' ','#'］,
［' ',' ','#',' ','#','#',' ','#',' ','#'］,
［'#','#','#',' ','#','#',' ',' ',' ','#'］,
［'#','#','#',' ','#','#','#','#',' ','#'］,
［'#',' ',' ',' ','#',' ','#','#',' ','#'］,
［'#',' ','#','#','#',' ','#','#',' ','#'］,
［'#',' ',' ',' ',' ',' ','#','#',' ',' '］,
［'#','#','#','#','#','#','#','#','#','#'］]